2 13 31
###############################
#       s  b      * * *      *#
#         f             # #*# #
# x  * * *** **      *    **  #
# #*# # # # ### #b# # # # # #*#
#       1  *     **      *  **#
# # x*# # # # # #*#*#*#*# # # #
#   *        *   b *s* *      #
# # # # #*# # # # # # #*# #*# #
#   ***f         *            #
# # # # # # # # # #*# # # # #*#
#  ** *   *                   #
###############################